1111111111111111
10C100000C0000P1
1001000000011111
1100011100000001
100111111C000101
100L1E00L0001E01
1111111111111111